111111e11111
1E1000C0C0P1
100C0R0C0001
111111111111